11111111111111111111
10000PP0000000000011
1E0000000C00C0000001
11111111111111111111