11111111111111111111
100000PP000000000001
1E0000000C00C0000001
11111111111111111111