11111111111111111111
1E0000000000000C00P1
11111111111111111111
