11111111111111111111
1E0000000000000C0001
10100101001000001011
10100100101010100011
1P0011001C01C0000001
1001C00010010001C101
10C10011C00100C10001
11111111111111111111

