11111111111111111111
10100P00100000100011
1E001100001000000111
11111111111111111111