11111111111111111111
10100000100000100011
1P0011000C01C0000001
11111111111111111111