1111111
100P001
10C00E11
1111111