1111111
100P0C0
1E00001
1111111