111111111111111
10000P00CCCCCC1
1CCC00000ECCCC1
100000000000001
111111111111111

