1111111111111
1X010000001C1
1XXX011111011
1XX011XXXXXX1
1111111111111